11 9
0 0
2	14	14	14	14	14	14	2	0	0	0
13	0	0	0	0	0	0	13	0	0	0
13	0	0	0	0	0	0	13	0	51	52
13	0	0	0	0	0	0	13	0	53	54
13	0	0	0	0	0	0	13	0	55	56
13	0	0	0	0	0	0	13	0	57	58
13	0	0	0	0	0	0	13	0	59	60
13	0	0	0	0	0	0	13	0	0	0
2	14	14	14	14	14	14	2	0	0	0