15 15
0 0
2 2 2 2 2 2 2 2 2 2 2 2 2 0 0
2 0 0 0 0 13 0 0 0 0 0 0 2 0 0
2 0 0 0 0 13 0 0 0 0 0 0 2 0 0
2 0 0 13 14 14 14 13 0 0 0 0 2 0 0
2 0 0 13 2 0 2 13 0 0 0 0 2 0 0
2 0 0 13 0 13 0 13 0 0 0 0 2 51 52
2 0 0 13 2 0 2 13 0 0 0 0 2 53 54
2 0 0 13 14 14 14 13 0 0 0 0 2 55 56
2 0 0 0 0 0 0 13 0 0 0 0 2 57 58
2 0 0 0 0 0 0 13 0 0 0 0 2 59 60
2 0 0 0 0 0 0 13 0 0 0 0 2 0 0
2 0 0 0 0 0 0 13 0 0 0 0 2 0 0
2 0 0 0 0 0 0 13 0 0 0 0 2 0 0
2 0 0 0 0 0 0 13 0 0 0 0 2 0 0
2 0 0 0 0 0 0 13 0 0 0 0 2 0 0
2 2 2 2 2 2 2 2 2 2 2 2 2 0 0